............................................................
............................T...............................
............................................................
............................................................
............................................................
............................................................
......................***...................................
....................********....*******.....................
..................************.**********...................
.................************************...................
.................*************************..................
................***************************.................
................******.....*.***.....******.................
................*****......**.**......*****.................
................*****......*****......*****.................
................*****......******.....*****.................
................*****....**********...*****.................
................***.*******************..**.................
...........L....***************************.................
................***********.....***********.................
.................********.........*********.................
.................**********......*********..................
..................************************..................
..................*********.....*********...................
...................******.........*******...................
...................******..........*****....................
....................***.............***.....................
.....................****...***....***......................
.......................**************.......................
........................************........................
...........................*******..........................
............................................................
............................................................
