****************************************
*......................................*
*..................................T...*
*......................................*
*......................................*
*..................*...................*
*..................*...................*
*..................*...................*
*..................*...................*
*......................................*
*......................................*
*...........****.......****............*
*......................................*
*......................................*
*..................*...................*
*..................*...................*
*..................*...................*
*..................*...................*
*......................................*
*......................................*
*......................................*
*..P...................................*
****************************************