****************************************
*......................................*
*......................................*
*......................................*
*......................................*
*..................*...................*
*..................*...................*
*..................*...................*
*..................*...................*
*......................................*
*......................................*
*.........T.****.......****..L.........*
*......................................*
*......................................*
*..................*...................*
*..................*...................*
*..................*...................*
*..................*...................*
*......................................*
*......................................*
*......................................*
*......................................*
****************************************